#comments prefixed with #	
#headers:	
#label	is_body
Document	FALSE
Publication info:	FALSE
Abstract:	FALSE
Links:	FALSE
Full text:	TRUE
Subject:	FALSE
Title:	FALSE
Publication title:	FALSE
Publication year:	FALSE
Publication date:	FALSE
Year:	FALSE
Dateline:	FALSE
Publisher:	FALSE
Place of publication:	FALSE
Country of publication:	FALSE
Publication subject:	FALSE
Source type:	FALSE
Language of publication:	FALSE
Document type:	FALSE
ProQuest document ID:	FALSE
Document URL:	FALSE
Copyright:	FALSE
Last updated:	FALSE
Database:	FALSE
Credit:	FALSE
Company / organization:	FALSE
#
# for original KFT
#
LINK TO DOCUMENT IN PROQUEST	FALSE
ABSTRACT	FALSE
FULL TEXT	TRUE
INDEX FIELDS	FALSE
#
# Another style
#

***** Abstract (Summary) *****	FALSE
***** Full Text *****	TRUE
***** Indexing (document details) *****	FALSE
Subjects:	FALSE
Companies:	FALSE
Document types:	FALSE